clara 		k l a r a
direita		dZ i r e j t a
esquerda 	e s k e R d a
baixo 		b a j S u
cima 		s i~ m a
centralizar 	s e~ t r a l i z a X
centralizar(2) 	s e~ t r a l i z a
menu 		m e n u
configuração 	k o~ f i g u r a s a~ w~
configuração(2) k o~ f i g u r a X
configurações	k o~ f i g u r a s o~ j~ s
iniciar 	i~ n i s i a X
iniciar(2)	i~ n i s i a
pausar 		p a w z a X
pausar(2)	p a w z a
parar 		p a r a X
parar(2)	p a r a
aumentar 	a u~ m e~ t a X
afastar		a f a s t a X
visão 		v i z a~ w~
girar 		Z i r a X
gravação 	g r a v a s a~ w~
inverter 	i~ v e X t e X
inverter(2) 	i~ v e X tS i
controle 	k o~ t r o l i
controles 	k o~ t r o l i s
com 		k o~
sem 		s e~ j~
marcador 	m a X k a d o X
microfone 	m i k r o f o~ n i
achar 		a S a X
ferramenta 	f e R a m e~ t a

